WWWWWWWWWWWWWWWWWW
W..P1.............W
W......WWWWW.......W
W..............P2..W
W...WW..............W
WWWWWWWWWWWWWWWWWW