WWWWWWWWWWWWWWWWWWWWWW
W....................W
W.P1..W....W...W.....W
W....D.D...W...W.....W
W.WDDDWD.DDDDDWWWDDW.W
W.....W.D.DWD.D.D....W
W..DD.W..DDDDDDWDDD..W
W.WDD.WWDWDWDWD.WDDW.W
W....D.D.D.D.DD......W
W....DWD...W..DW.P2..W
W....................W
WWWWWWWWWWWWWWWWWWWWWW
