WWWWWWWWWWWWWWWWWWWWWW
W....................W
W.P1.D.D..W.....W....W
W....DWDWDWDWW.WWWW..W
W..DD.W.DDDDD.DD.DD..W
W.....W..DWD.D.DWD...W
W..DD.W.D.D.D.D.WDD..W
W..DD.W..D.D.D..WDD..W
W.WWWW.WDDDDDWDW...W.W
W....D.D..W....D.P2..W
W....D.D.......D.....W
WWWWWWWWWWWWWWWWWWWWWW
