WWWWWWWWWWWWWWWWWWWWWW
W....................W
W.P1..D.D.W.....W....W
W....WDWDDWDW.WWWW.W.W
W......WDDDDD.DD.D...W
W..DD..W.DWD.D.DWDD..W
W..DD..WD.D.D.D.WDD..W
W......W.D.D.D..W....W
W.WDD.WWDDDDDWD....W.W
W.....D.D.W....D.P2..W
W.....D.D......D.....W
WWWWWWWWWWWWWWWWWWWWWW
