WWWWWWWWWWWWWWWWW
W..P1.......W...W
W......WWW......W
W.............P2W
W....W..........W
WWWWWWWWWWWWWWWWW