WWWWWWWWWWWWWWWWWWWW
W..................W
W..P1..W...W...P2..W
W......W......W....W
W......W.....W.....W
W......W...W.......W
W..D...W......W....W
W......W......W....W
W......W...D..W....W
W......W......W....W
WWWWWWWWWWWWWWWWWWWW