WWWWWWWWWWWWWWWWWWWWWW
W....................W
W.P1...W..D.D..W.....W
W......W..DWD.D.D....W
W.WWWW.WWDWDWDDWDWWW.W
W..DD.D.D.DWD.DW.DD..W
W..DD.D.DD.D.DD.DDD..W
W.W.WWDWDWDWD.DWDW.W.W
W..DD..W.DDDDD.W.....W
W......W..DWD..W.P2..W
W....................W
WWWWWWWWWWWWWWWWWWWWWW
