WWWWWWWWWWWWWWWWWWWWWW
W....................W
W.P1...W...W...W.....W
W.....D.D..W...W.....W
W.WWW.DWDDDDDDW.WWWW.W
W..DD..WD.DWD.D.DDD..W
W..DD..W.DDDDDDWDDD..W
W..WWWW.DWDWDWDWW.WW.W
W..DD.D.DD.D.DD......W
W.....DWD..W..DW.P2..W
W....................W
WWWWWWWWWWWWWWWWWWWWWW
