WWWWWWWWWWWWWWWWWWWWWW
W....................W
W.P1..W...W....D.D...W
W.....WWWW.WWWWDWDWW.W
W..DDD.DD.D.D.D.WDD..W
W....DWD.D.D.D..W....W
W..DD.W.DDDDD.D.WDD..W
W..DDD.D.DWD.D.D.DD..W
W..WWDWDDWDWDWDD...W.W
W.....W..D.D.....P2..W
W........D.D.........W
WWWWWWWWWWWWWWWWWWWWWW
