WWWWWWWWWWWWWWWWWWWWWW
W....................W
W.P1.W....W....D.D...W
W....W.WWWW.WWWD.DWW.W
W..DD.D.D.D.D.D.WDD..W
W..DDWD..D.D.D..WDD..W
W....W..DDDDD.D.W....W
W..DD.D..DWD.D.D.DD..W
W.WDDWDWDWDWD.DD...W.W
W....W...D.D.....P2..W
W........D.D.........W
WWWWWWWWWWWWWWWWWWWWWW
