WWWWWWWWWWWWWWWWWWWWWW
W....................W
W.P1..D...W.....W....W
W.....DWWD.DWWW.WWWW.W
W..DDW..DDDDD.DD.DD..W
W..DDW...DWD.D.DWDD..W
W....W..D.D.D.D.W....W
W..DDW...D.D.D..WDD..W
W..DDWW.DDDDDWDW...W.W
W...D.D...W....D.P2..W
W...D.D........D.....W
WWWWWWWWWWWWWWWWWWWWWW
