WWWWWWWWWWWWWWWW
W..............W
W..P1......P2..W
W......WW......W
WWWWWWWWWWWWWWWW