WWWWWWWWWWWWWWWWWWWWWW
W....................W
W.P1.W....D.D..W.....W
W....W....DWD.D.D....W
W.WDDWWW.DWDWDDWDDDW.W
W..DD.D.D.DWD.DW.DD..W
W...D.D..D.D.DD.D....W
W.WDD.DWDWDWDWD.DDDW.W
W..DDW...DDDDD.W.....W
W....W....DWD..W.P2..W
W....................W
WWWWWWWWWWWWWWWWWWWWWW
