WWWWWWWWWWWWWWWWWWWWWW
W....................W
W.P1.W.....W...W.....W
W.....D....W...W.....W
W.WDDWDWWDDDDD.WWDD..W
W..DDW..D.DWD.D.DDD..W
W....W...DDDDDDWD....W
W.WDDW.WDWD.DWDW.DDW.W
W..DD.D..D.D.DD......W
W...DWD....W..DW.P2..W
W....................W
WWWWWWWWWWWWWWWWWWWWWW
