WWWWWWWWWWWWWWWWWWWWWW
W....................W
W.P1...W..W....D.D...W
W....WW.WWWW.WWDWDWW.W
W.....D.D.D.D.D.W....W
W..DD.DWDD.D.D..WDD..W
W..DD..WDDDDD.D.WDD..W
W.....D.DDWD.D.D.D...W
W.WDDWDWD.DWDWDD.....W
W......W.D.D.....P2..W
W........D.D.........W
WWWWWWWWWWWWWWWWWWWWWW
