WWWWWWWWWWWWWWWW
W..P1.....WW...W
W......W......PW
W...WW.......P2W
WWWWWWWWWWWWWWWW