WWWWWWWWWWWWWWWWWWWWWW
W....................W
W.P1..W...D.D..W.....W
W.....W...DWD.D.D....W
W..DDWW.WDWD.DDWDDDW.W
W....D.DD.DWD.DW.....W
W..DDD.D.D.D.DD.DDD..W
W.WDDDWDD.DWDWDWDDD..W
W.....W..DDDDD.W.....W
W.....W...DWD..W.P2..W
W....................W
WWWWWWWWWWWWWWWWWWWWWW
