WWWWWWWWWWWWWWWWWWW
W..P1......W........W
W......WWWWW........W
W.................P2W
W...WW...............W
WWWWWWWWWWWWWWWWWWW